1 99
 ###########
##         #
#       *  #
# $        #
#+         #
############