10 35 40
##########
#   .    #
#   **@  #
# $      #
#        #
##########