12 56 60 43
#####
#  .#####
# #$#   #
#       #
# $   $ #
#  # # ##
#       #
#  $  .#
#+  .###
######