23 5 11 17
############
#     @    #
#   $..$   #
#   $..$   #
#          #
############