1
#############
#      @    #
#           #
# $      .  #
#           #
#############