1 100
############
#         .#
# $        #
#    #$  . #
#    @     #
############