1 15
##########
#   .    #
#    $   #
#   ###  #
# @      #
#   ###  #
#    $   #
#       .#
##########