50 20 5 30
###############
#          #..#
#  $   $   #..#
#            $#
#   @$     #  #
#             #
###############