12 43 27
   #####
   #  .# 
  ## # ####
 ##  ##   #
## $      #
#   @$    #
### $###  #
  #  #    #
 ##  #.#.##
 #      ##
 #     ##
 #######