23 5 11
###########
#.  #     #
#  $#   $ #
#     .   #
#@  #     #
#.    $   #
###########