10 99
 ###########
##         #
#    $  .  #
#   $      #
#+         #
############