1
#########
#       #
# @     #
# $     #
#      .#
#########