1 99
 ###########
##         #
#     .    #
# $ $      #
#  @      .#
############