1
 ###########
##         #
#     $    #
# ######   #
#@  .      #
############