34 2 43 
#####
#   #####
# # #   #
#       #
# $   $ #
#  # # ##
#       #
#  $  .#
#+  .###
######