1
#########
#       #
# @     #
# $ .   #
#       #
#########